###############################
#.......S.....................#
#.............................#
#.....##D###....#########.....#
#.....#....#....#.......#.....#
#.....#..P.#....#..C....#.....#
#.....#....#....#.......#.....#
#.....######....####D####.....#
#.............................#
###############################
